{
  "FieldInfo": [
      [ 4, 4, 4, 3, 3, 3, 3, 3, 5, 5, 5, 3, 3, 3, 3, 3, 4, 4, 4, 3, 3, 3, 3, 3, 5, 5, 5, 3, 3, 3, 3, 3, 3, 3, 3, 3, 3, 3, 3, 3, 3, 3, 3, 3, 4, 3, 3, 3, 4, 3, 3, 3, 4, 3, 3, 3, 4, 3, 3, 3 ],
      [ 3, 3, 3, 4, 3, 3, 3, 5, 3, 3, 3, 5, 3, 3, 3, 4, 3, 3, 3, 4, 3, 3, 3, 5, 3, 3, 3, 5, 3, 3, 3, 3, 3, 3, 3, 3, 3, 3, 3, 3, 3, 3, 3, 3, 4, 3, 3, 3, 4, 3, 3, 3, 4, 3, 3, 3, 4, 3, 3, 3 ],
      [ 3, 0, 3, 4, 3, 3, 3, 5, 3, 3, 3, 5, 3, 3, 3, 4, 3, 3, 3, 4, 3, 3, 3, 5, 3, 3, 3, 5, 3, 3, 3, 3, 3, 3, 3, 3, 3, 3, 3, 3, 3, 5, 5, 5, 3, 4, 4, 4, 3, 4, 4, 4, 3, 4, 4, 4, 3, 5, 5, 5 ],
      [ 3, 3, 3, 4, 3, 3, 3, 5, 3, 3, 3, 5, 3, 3, 3, 4, 3, 3, 3, 4, 3, 3, 3, 5, 3, 3, 3, 5, 3, 3, 3, 3, 3, 3, 3, 3, 3, 3, 3, 3, 5, 3, 3, 3, 5, 3, 3, 3, 4, 3, 3, 3, 4, 3, 3, 3, 5, 3, 3, 3 ],
      [ 4, 4, 4, 3, 4, 4, 4, 3, 5, 5, 5, 3, 4, 4, 4, 3, 4, 4, 4, 3, 4, 4, 4, 3, 5, 5, 5, 3, 3, 3, 3, 3, 3, 3, 3, 3, 3, 3, 3, 3, 5, 3, 3, 3, 5, 3, 3, 3, 4, 3, 3, 3, 4, 3, 3, 3, 5, 3, 3, 3 ],
      [ 3, 3, 3, 4, 3, 3, 3, 4, 3, 3, 3, 4, 3, 3, 3, 4, 3, 3, 3, 4, 3, 3, 3, 4, 3, 3, 3, 3, 3, 3, 3, 3, 3, 3, 3, 3, 3, 3, 3, 3, 5, 3, 3, 3, 5, 3, 3, 3, 4, 3, 3, 3, 4, 3, 3, 3, 5, 3, 3, 3 ],
      [ 3, 3, 3, 4, 3, 3, 3, 4, 3, 3, 3, 4, 3, 3, 3, 4, 3, 3, 3, 4, 3, 3, 3, 4, 3, 3, 3, 3, 3, 3, 3, 3, 3, 3, 3, 3, 3, 4, 4, 4, 3, 5, 5, 5, 3, 4, 4, 4, 3, 4, 4, 4, 3, 4, 4, 4, 3, 5, 5, 5 ],
      [ 3, 3, 3, 4, 3, 3, 3, 4, 3, 3, 3, 4, 3, 3, 3, 4, 3, 3, 3, 4, 3, 3, 3, 4, 3, 3, 3, 3, 3, 3, 3, 3, 3, 3, 3, 3, 4, 3, 3, 3, 4, 3, 3, 3, 4, 3, 3, 3, 4, 3, 3, 3, 4, 3, 3, 3, 4, 3, 3, 3 ],
      [ 5, 5, 5, 3, 4, 4, 4, 3, 4, 4, 4, 3, 4, 4, 4, 3, 5, 5, 5, 3, 4, 4, 4, 3, 3, 3, 3, 3, 3, 3, 3, 3, 3, 3, 3, 3, 4, 3, 3, 3, 4, 3, 3, 3, 4, 3, 3, 3, 4, 3, 3, 3, 4, 3, 3, 3, 4, 3, 3, 3 ],
      [ 3, 3, 3, 5, 3, 3, 3, 4, 3, 3, 3, 4, 3, 3, 3, 5, 3, 3, 3, 5, 3, 3, 3, 3, 3, 3, 3, 3, 3, 3, 3, 3, 3, 3, 3, 3, 4, 3, 3, 3, 4, 3, 3, 3, 4, 3, 3, 3, 4, 3, 3, 3, 4, 3, 3, 3, 4, 3, 3, 3 ],
      [ 3, 3, 3, 5, 3, 3, 3, 4, 3, 3, 3, 4, 3, 3, 3, 5, 3, 3, 3, 5, 3, 3, 3, 3, 3, 3, 3, 3, 3, 3, 3, 3, 3, 5, 5, 5, 3, 4, 4, 4, 3, 4, 4, 4, 3, 4, 4, 4, 3, 5, 5, 5, 3, 4, 4, 4, 3, 4, 4, 4 ],
      [ 3, 3, 3, 5, 3, 3, 3, 4, 3, 3, 3, 4, 3, 3, 3, 5, 3, 3, 3, 5, 3, 3, 3, 3, 3, 3, 3, 3, 3, 3, 3, 3, 5, 3, 3, 3, 5, 3, 3, 3, 4, 3, 3, 3, 4, 3, 3, 3, 5, 3, 3, 3, 5, 3, 3, 3, 4, 3, 3, 3 ],
      [ 5, 5, 5, 3, 4, 4, 4, 3, 4, 4, 4, 3, 4, 4, 4, 3, 5, 5, 5, 3, 3, 3, 3, 3, 3, 3, 3, 3, 3, 3, 3, 3, 5, 3, 3, 3, 5, 3, 3, 3, 4, 3, 3, 3, 4, 3, 3, 3, 5, 3, 3, 3, 5, 3, 3, 3, 4, 3, 1, 3 ],
      [ 3, 3, 3, 4, 3, 3, 3, 4, 3, 3, 3, 4, 3, 3, 3, 4, 3, 3, 3, 3, 3, 3, 3, 3, 3, 3, 3, 3, 3, 3, 3, 3, 5, 3, 3, 3, 5, 3, 3, 3, 4, 3, 3, 3, 4, 3, 3, 3, 5, 3, 3, 3, 5, 3, 3, 3, 4, 3, 3, 3 ],
      [ 3, 3, 3, 4, 3, 3, 3, 4, 3, 3, 3, 4, 3, 3, 3, 4, 3, 3, 3, 3, 3, 3, 3, 3, 3, 3, 3, 3, 3, 3, 3, 3, 3, 5, 5, 5, 3, 3, 3, 3, 3, 4, 4, 4, 3, 3, 3, 3, 3, 5, 5, 5, 3, 3, 3, 3, 3, 4, 4, 4 ]
  ],
  "NPCsInfo": [
    {
      "Item1": 12,
      "Item2": 58
    }
  ],
  "PlayerInfo": {
    "Item1": 2,
    "Item2": 1
  },
  "Name": "ParallelLevel"
}