{
  "FieldInfo": [
      [ 3, 3, 3, 3, 3, 3, 3, 3, 3, 3, 3, 3, 3, 3, 3, 3, 3, 3, 3, 3, 3, 3, 3, 3, 3, 3, 3, 3, 3, 3, 3, 3, 3, 3, 3, 3, 3, 3, 3, 3, 3, 3, 3, 3, 3, 3, 3, 3, 3, 3, 3, 3, 3, 3, 3, 3, 3, 3, 3, 3 ],
      [ 3, 3, 3, 3, 3, 3, 3, 3, 3, 3, 3, 3, 3, 3, 3, 3, 3, 3, 3, 3, 3, 3, 3, 3, 3, 3, 3, 3, 3, 3, 3, 3, 3, 3, 3, 3, 3, 3, 3, 3, 3, 3, 3, 3, 3, 3, 3, 3, 3, 3, 3, 3, 3, 3, 3, 3, 3, 3, 3, 3 ],
      [ 3, 5, 5, 5, 3, 3, 5, 3, 3, 5, 5, 3, 3, 3, 3, 3, 3, 3, 3, 3, 3, 3, 3, 3, 4, 4, 4, 4, 1, 4, 4, 4, 4, 3, 3, 3, 3, 3, 3, 3, 3, 3, 3, 3, 3, 3, 5, 3, 3, 3, 5, 5, 5, 3, 5, 5, 5, 3, 3, 3 ],
      [ 3, 3, 5, 3, 3, 5, 5, 5, 3, 5, 3, 5, 3, 3, 3, 3, 3, 3, 3, 3, 3, 4, 4, 4, 3, 3, 3, 3, 4, 3, 3, 3, 3, 4, 4, 4, 3, 3, 3, 3, 3, 3, 3, 3, 3, 5, 3, 5, 3, 3, 5, 3, 3, 3, 3, 5, 3, 3, 3, 3 ],
      [ 3, 3, 5, 3, 3, 5, 3, 5, 3, 5, 3, 5, 3, 3, 3, 3, 3, 3, 3, 4, 4, 3, 3, 3, 3, 3, 3, 3, 4, 3, 3, 3, 3, 3, 3, 3, 4, 4, 3, 3, 3, 3, 3, 3, 3, 5, 3, 3, 3, 3, 5, 3, 3, 3, 3, 5, 3, 3, 3, 3 ],
      [ 3, 3, 5, 3, 3, 5, 3, 5, 3, 5, 3, 5, 3, 3, 3, 3, 3, 3, 4, 3, 3, 3, 3, 3, 3, 3, 3, 3, 4, 3, 3, 3, 3, 3, 3, 3, 3, 3, 4, 3, 3, 3, 3, 3, 3, 5, 3, 3, 3, 3, 5, 3, 3, 3, 3, 5, 3, 3, 3, 3 ],
      [ 3, 3, 5, 3, 3, 5, 3, 5, 3, 5, 5, 3, 3, 3, 3, 3, 3, 4, 3, 3, 3, 3, 3, 3, 3, 3, 3, 3, 3, 3, 3, 3, 3, 3, 3, 3, 3, 3, 3, 4, 3, 3, 3, 3, 3, 5, 3, 3, 3, 3, 5, 3, 3, 3, 3, 5, 3, 3, 3, 3 ],
      [ 3, 3, 5, 3, 3, 5, 3, 5, 3, 5, 3, 5, 3, 3, 3, 3, 1, 4, 4, 4, 4, 3, 3, 3, 3, 3, 3, 3, 0, 3, 3, 3, 3, 3, 3, 3, 4, 4, 4, 4, 1, 3, 3, 3, 3, 5, 3, 3, 3, 3, 5, 3, 3, 3, 3, 5, 3, 3, 3, 3 ],
      [ 3, 3, 5, 3, 3, 5, 5, 5, 3, 5, 3, 5, 3, 3, 3, 3, 3, 4, 3, 3, 3, 3, 3, 3, 3, 3, 3, 3, 3, 3, 3, 3, 3, 3, 3, 3, 3, 3, 3, 4, 3, 3, 3, 3, 3, 5, 3, 3, 3, 3, 5, 5, 3, 3, 3, 5, 3, 3, 3, 3 ],
      [ 3, 3, 5, 3, 3, 5, 3, 5, 3, 5, 3, 5, 3, 3, 3, 3, 3, 3, 4, 3, 3, 3, 3, 3, 3, 3, 3, 3, 4, 3, 3, 3, 3, 3, 3, 3, 3, 3, 4, 3, 3, 3, 3, 3, 3, 5, 5, 5, 3, 3, 5, 3, 3, 3, 3, 5, 3, 3, 3, 3 ],
      [ 3, 3, 5, 3, 3, 5, 3, 5, 3, 5, 3, 5, 3, 3, 3, 3, 3, 3, 3, 4, 4, 3, 3, 3, 3, 3, 3, 3, 4, 3, 3, 3, 3, 3, 3, 3, 4, 4, 3, 3, 3, 3, 3, 3, 3, 5, 3, 5, 3, 3, 5, 3, 3, 3, 3, 5, 3, 3, 3, 3 ],
      [ 3, 3, 5, 3, 3, 5, 3, 5, 3, 5, 3, 5, 3, 3, 3, 3, 3, 3, 3, 3, 3, 4, 4, 4, 3, 3, 3, 3, 4, 3, 3, 3, 3, 4, 4, 4, 3, 3, 3, 3, 3, 3, 3, 3, 3, 5, 3, 5, 3, 3, 5, 3, 3, 3, 3, 5, 3, 3, 3, 3 ],
      [ 3, 3, 5, 3, 3, 5, 3, 5, 3, 5, 3, 5, 3, 3, 3, 3, 3, 3, 3, 3, 3, 3, 3, 3, 4, 4, 4, 4, 1, 4, 4, 4, 4, 3, 3, 3, 3, 3, 3, 3, 3, 3, 3, 3, 3, 3, 5, 3, 3, 3, 5, 5, 5, 3, 3, 5, 3, 3, 3, 3 ],
      [ 3, 3, 3, 3, 3, 3, 3, 3, 3, 3, 3, 3, 3, 3, 3, 3, 3, 3, 3, 3, 3, 3, 3, 3, 3, 3, 3, 3, 3, 3, 3, 3, 3, 3, 3, 3, 3, 3, 3, 3, 3, 3, 3, 3, 3, 3, 3, 3, 3, 3, 3, 3, 3, 3, 3, 3, 3, 3, 3, 3 ],
      [ 3, 3, 3, 3, 3, 3, 3, 3, 3, 3, 3, 3, 3, 3, 3, 3, 3, 3, 3, 3, 3, 3, 3, 3, 3, 3, 3, 3, 3, 3, 3, 3, 3, 3, 3, 3, 3, 3, 3, 3, 3, 3, 3, 3, 3, 3, 3, 3, 3, 3, 3, 3, 3, 3, 3, 3, 3, 3, 3, 3 ]
  ],
  "NPCsInfo": [
    {
      "Item1": 2,
      "Item2": 28
    },
    {
      "Item1": 7,
      "Item2": 16
    },
    {
      "Item1": 7,
      "Item2": 40
    },
    {
      "Item1": 12,
      "Item2": 28
    }
  ],
  "PlayerInfo": {
    "Item1": 7,
    "Item2": 28
  },
  "Name": "TargetLevel"
}